N=10, M=10, P=15
##########
#S0000000#
#0#######0#
#0#T000#0#
#0#####0#0#
#000000#0#0#
#0#####0#0#
#0#00000#0#
#0#######0#
#00000000E#
##########