N=20, M=20, P=10
#21#201#32412#004001
00#01011#00#04#4110#
1#00#010###3001#11#1
#0###02#0111#1##1000
006102#010011#00#112
#3#130#220003013301#
00320010000#####0111
0111##0##1201#312#31
0032100#10#E011##1#0
1#3###52230#2#11#0#0
000###032##231001#11
24#031101000#16#1000
110000###04110000002
010000#0#00001500#02
013#2020#0019#03##00
01#0#3#00#0#113#022#
#20311#0100004140013
#71##203##10002#0#S0
#300#10902600#00##0#
#0000202113#02#0110#
