N=20, M=20, P=10
#TTTTTT#T0000E000#TT
TT#TTTTTT000000T0###
TT#TT###T000T0000##T
#TTTTT##T00TT000#T#T
TTTTT#TTTT#TT000TTT#
T#TTTTT#TTTTT000TT#T
TT#T##TT#TTTT0TT00T#
TTTTTTT#TT##T000000T
TT#TT##TT##TTT#T000T
TTTTTTTTTTTTT##00TTT
#TTTTTTTTTTT#TT0TTTT
T#T######TTTTTT0TTTT
#T#T#T#T####T##000TT
##T#T#TT##T##TTT00T#
TT#T####T#T#T#000#TT
#T##TTTT#T#T#T0TT#TT
T#TTTTTT###TT#0STTT#
#T#TT#TT#TTT#T###T#T
T#TTT#T#TTTTTTT#T#TT
T#TTT###TTT###T##T#T
