N=20, M=20, P=10
00002#100####1001#22
210#0#241#1#110#011#
201#10#00###1#10#5#2
20##021#0#00#0011#10
04#00020##310#02#24#
012#0#42#422311111#0
3#0000#20#30500600##
02##310100#02#0000##
1#0000#10001120130#0
000#001#0#1#0#002010
10000101#1#30##000##
00##634#0#02#0030#00
2300#0##1#010101#0#6
1#0000100020033##0S#
0#02#0#0##14#0021#13
#0##011111##0#20##1#
#1#151##0120##1#0011
###205022##0#E#01#40
0#221741#0#2110#0##0
#0#0#101###0000##114
